################################################################
#.........>..=....................................t............#
#..............................................................#
#..............................................................#
#..............................................................#
#..............................................................#
#..............................................................#
#..............................................................#
#..............................................................#
#..............................................................#
#..............................................................#
#..............................................................#
#..............................................................#
#..............................................................#
#..............................................................#
#..............................................................#
#..............................................................#
#..............................................................#
#..............................................................#
#..............................................................#
#..............................................................#
#..............................................................#
#..............................................................#
#..............................................................#
#..............................................................#
#..............................................................#
#..............................................................#
#..............................................................#
#..............................................................#
#..............................................................#
#............................########..........................#
#............................#...⊕..#..........................#
#............................#,.&.=.#..........................#
#............................#......#..........................#
#............................###+####..........................#
#..............................................................#
#..............................................................#
#..............................................................#
#..............................................................#
#..............................................................#
#..............................................................#
#..............................................................#
#..............................................................#
#..............................................................#
#..............................................................#
#..............................................................#
#..............................................................#
#..............................................................#
#..............................................................#
#..............................................................#
#..............................................................#
#..............................................................#
#..............................................................#
#..............................................................#
#..............................................................#
#..............................................................#
#..............................................................#
#..............................................................#
#..............................................................#
#..............................................................#
#..............................................................#
#..............................................................#
#..............................................................#
################################################################
K
################################################################
#.........<.=..................................................#
#..............................................................#
#..............................................................#
#..............................................................#
#..............................................................#
#..............................................................#
#..............................................................#
#..............................................................#
#..............................................................#
#..............................................................#
#..............................................................#
#..............................................................#
#..............................................................#
#..............................................................#
#..............................................................#
#..............................................................#
#..............................................................#
#..............................................................#
#..............................................................#
#..............................................................#
#..............................................................#
#..............................................................#
#..............................................................#
#..............................................................#
#..............................................................#
#..............................................................#
#..............................................................#
#..............................................................#
#..............................................................#
#..............................................................#
#..............................................................#
#..............................................................#
#..............................................................#
#..............................................................#
#..............................................................#
#..............................................................#
#..............................................................#
#..............................................................#
#..............................................................#
#..............................................................#
#..............................................................#
#..............................................................#
#..............................................................#
#..............................................................#
#..............................................................#
#..............................................................#
#..............................................................#
#..............................................................#
#..............................................................#
#..............................................................#
#..............................................................#
#..............................................................#
#..............................................................#
#..............................................................#
#..............................................................#
#..............................................................#
#..............................................................#
#..............................................................#
#..............................................................#
#..............................................................#
#..............................................................#
#..............................................................#
################################################################

FVTAF
Gurfr ner fgnvef qbja.
Gurer'f n ont arne urer. Vg unf n tvsg sbe lbh va vg!

Jubn, vg'f qnex qbja urer! Gurer fubhyq or n gbepu ba gur tebhaq arneol.

PBAGNVAREF

ybns
crooyr
eng pbecfr

crooyr

ORFGVNEL
-tboyva:
    uc: 5
    qnzntr: 1
    nezbe: 0
    yhpx: 1
    ontFybgf: 5
    sbrf: cynlre
    sevraqf: tboyva, eng
    fvtug: 10
    fcrrq: 1
    pune: t
    st: yvtugterra
    ot: oynpx
    ybbg: ovg bs fgevat*70, ovg bs jver*10
    gntf: ivpvbhf, ubneqvat
-eng:
    uc: 3
    qnzntr: 1
    nezbe: 0
    yhpx: 1
    ontFybgf: 0
    sbrf: cynlre
    sevraqf: tboyva, eng
    fvtug: 10
    fcrrq: 1
    pune: e
    st: yvtugoebja
    ot: oynpx
    ybbg: eng pbecfr*100
    gntf: irezva

INHYG
-crooyr:
    grkg: Fznyy, fzbbgu fgbar.
    pune: ,
    st: yvtugterl
    ot: oynpx
    gntf: guebjnoyr
-ont:
    grkg: Fznyy pybgu ont, fhvgnoyr sbe pneelvat n srj vgrzf.
    pune: &
    st: yvtugterl
    ot: oynpx
    gntf: pbagnvare
    fybgf: 5
-ybns:
    grkg: Fgnyr ybns bs oernq. Uneq naq purjl, ohg svyyvat.
    pune: ⊕
    st: yvtugfnyzba
    ot: oynpx
    gntf: sbbq
    sbbqInyhr: 2
-ovg bs fgevat:
    grkg: Ovg bs snqrq fgevat. Vg'f abg irel hfrshy.
    pune: ~
    st: yvtugterl
    ot: oynpx
    gntf: whax
-ovg bs jver:
    grkg: Orag ovg bs pbccre jver. Vg'f abg irel hfrshy, ohg vg tyvggref.
    pune: ~
    st: pbeny
    ot: oynpx
    gntf: whax
-eng pbecfr
    grkg: Pnepnff bs n fznyy, sheel, znzzny. Vg'f abg irel nccrgvmvat.
    pune: e
    st: oebja
    ot: oynpx
    gntf: sbbq
    sbbqInyhr: 0
