################################################################
#.........>..Ħ....................................g............#
#..............................................................#
#..............................................................#
#..............................................................#
#..............................................................#
#..............................................................#
#..............................................................#
#..............................................................#
#..............................................................#
#..............................................................#
#..............................................................#
#..............................................................#
#..............................................................#
#..............................................................#
#..............................................................#
#..............................................................#
#..............................................................#
#..............................................................#
#..............................................................#
#..............................................................#
#..............................................................#
#..............................................................#
#..............................................................#
#..............................................................#
#..............................................................#
#..............................................................#
#..............................................................#
#..............................................................#
#..............................................................#
#............................########..........................#
#............................#...⊕..#..........................#
#............................#,.&.Ħ.#..........................#
#............................#......#..........................#
#............................###+####..........................#
#..............................................................#
#..............................................................#
#..............................................................#
#..............................................................#
#..............................................................#
#..............................................................#
#..............................................................#
#..............................................................#
#..............................................................#
#..............................................................#
#..............................................................#
#..............................................................#
#..............................................................#
#..............................................................#
#..............................................................#
#..............................................................#
#..............................................................#
#..............................................................#
#..............................................................#
#..............................................................#
#..............................................................#
#..............................................................#
#..............................................................#
#..............................................................#
#..............................................................#
#..............................................................#
#..............................................................#
#..............................................................#
################################################################X################################################################
#.........<.Ħ..................................................#
#..............................................................#
#..............................................................#
#..............................................................#
#..............................................................#
#..............................................................#
#..............................................................#
#..............................................................#
#..............................................................#
#..............................................................#
#..............................................................#
#..............................................................#
#..............................................................#
#..............................................................#
#..............................................................#
#..............................................................#
#..............................................................#
#..............................................................#
#..............................................................#
#..............................................................#
#..............................................................#
#..............................................................#
#..............................................................#
#..............................................................#
#..............................................................#
#..............................................................#
#..............................................................#
#..............................................................#
#..............................................................#
#..............................................................#
#..............................................................#
#..............................................................#
#..............................................................#
#..............................................................#
#..............................................................#
#..............................................................#
#..............................................................#
#..............................................................#
#..............................................................#
#..............................................................#
#..............................................................#
#..............................................................#
#..............................................................#
#..............................................................#
#..............................................................#
#..............................................................#
#..............................................................#
#..............................................................#
#..............................................................#
#..............................................................#
#..............................................................#
#..............................................................#
#..............................................................#
#..............................................................#
#..............................................................#
#..............................................................#
#..............................................................#
#..............................................................#
#..............................................................#
#..............................................................#
#..............................................................#
#..............................................................#
################################################################

SIGNS
These are stairs down.
There's a bag near here. It has a gift for you in it!

Whoa, it's dark down here! There should be a torch on the ground nearby.

CONTAINERS

loaf
pebble
rat corpse

pebble

BESTIARY
-goblin:
    hp: 10
    damage: 2
    armor: 0
    luck: 1
    bagSlots: 5
    foes: player
    friends: goblin, rat
    sight: 10
    speed: 1
    char: g
    fg: lightgreen
    bg: black
    loot: bit of string*70, bit of wire*10
    tags: vicious, hoarding
-rat:
    hp: 3
    damage: 1
    armor: 0
    luck: 1
    bagSlots: 0
    foes: player
    friends: goblin, rat
    sight: 10
    speed: 1
    char: r
    fg: lightbrown
    bg: black
    loot: rat corpse*100
    tags: vermin

VAULT
-pebble:
    text: Small, smooth stone.
    char: ,
    fg: lightgrey
    bg: black
    tags: throwable
-bag:
    text: Small cloth bag, suitable for carrying a few items.
    char: &
    fg: lightgrey
    bg: black
    tags: container
    slots: 5
-loaf:
    text: Stale loaf of bread. Hard and chewy, but filling.
    char: ⊕
    fg: lightsalmon
    bg: black
    tags: food
    foodValue: 2
-bit of string:
    text: Bit of faded string. It's not very useful.
    char: ~
    fg: lightgrey
    bg: black
    tags: junk
-bit of wire:
    text: Bent bit of copper wire. It's not very useful, but it glitters.
    char: ~
    fg: coral
    bg: black
    tags: junk
-rat corpse
    text: Carcass of a small, furry, mammal. It's not very appetizing.
    char: r
    fg: brown
    bg: black
    tags: food
    foodValue: 0
